nocturnal - ночной
proprietor - собственник
mayor - мэр
arsenic - мышьяк
keg - бочонок
cipher - шифр
cufflinks - запонки
cesspool - выгребная яма
deluge - потоп
slum - трущобы
austerity - строгость, аскетизм
payroll - платежная ведомость
distraught - потерявший рассудок
rampant - безудержный
solitude - одиночество
contradiction - противоречие
turmoil - смятение
quantity - количество
guilt - вина, чувство вины
intrinsic - внутренний
hollow - пустой
toddler - ребенок, начинающий ходить
evaluate - оценивать
bulge - выпуклость, выступ
onboarding - адаптация
lair - логово
sewer - канализация
junction - перекресток
whereabouts - местонахождение
hangar - ангар
adjacency - смежность, соседство
leeway - свобода действий
atrocity - зверство
janitor - дворник
necessity - необходимость
bleach - отбеливатель
homogeneous - однородный
adage - поговорка
rigid - жёсткий
consistency - последовательность, постоянство
fidgety - суетливый
ransom, buyout - выкуп
perk up - взбодриться
concise, brief - краткий, лаконичный
gather - собирать
preoccupied, concerned - озабоченный
move to personalities - переход на личности
discarded - отброшен, выкинут
demand - требовать
crucial - ключевой
neglect - пренебрегать, халатное отношение
peninsula - полуостров
booze - выпивка
freeload - халява, нахлебничать
desolate - заброшенный, безлюдный
vow - клятва
repulsive - отталкивающий, отвратительный
tremendous - потрясающий
dignity - достоинство, благородство
mocked - высмеянный
fleas - блохи
crest - герб
mayhem - погром
sophomore - второкурсник
strain - напряжение
vast - огромный
boundary - граница
fad - прихоть
chore - работа по дому
humiliated - униженный
mustard - горчица
swallow - проглатывать
dissolve - растворить
boilerplate - шаблонный
retrieving - извлечение
appraisal - оценка
cite - цитировать, ссылаться
decisive - решающий
executive - исполнительный директор
shallow - мелкий, поверхностный
possess - владеть, обладать
sufficient - достаточный
loose coupling - слабая связь
cohesion - сплоченность, связь
redundant - лишний, избыточный
malevolent - злобный, злорадный
juxtaposition - сопоставление
crimson - малиновый, пунцовый
blissful - блаженный
whatsoever - что угодно, что бы то ни было
felony - уголовное преступление
mist - туман
urge - побуждение
vessel - судно, сосуд
intrude - вмешиваться, вторгаться
burden - груз, бремя
hone - оттачивать
curt - краткий, односложный
embrace - объятия
smuggler - контрабандист
perceive - воспринимать, чувствовать
participate - принимать участие
excuse - извинение, оправдание
divine - божественный
fallacy - заблуждение
refutation - опровержение
wager - пари, ставка
denigration - клевета
outlaw - вне закона
formidable - грозный, внушительный
carpenter - плотник
indeed - действительно
generalizability - обобщаемость
attitude - отношение
constraint - ограничение
convenience - удобство
stringent - строгий
persuasion - убедительность
setback - неудача
relentless, ruthless - безжалостный
bellwether - баран-вожак (с колокольчиком на шее)
monetary - денежный
sanctification - освящение
welfare - благосостояние
at first glance - на первый взгляд
rapport - взаимопонимание
idle - праздный